C 0 0 0 E 1 0 0 0 p
0 1 1 P 0 K e 1 0 K
0 0 e 0 0 1 0 1 0 E
K 0 1 0 K 0 0 0 0 1
0 0 1 0 1 p 1 0 K 1
E 1 0 0 0 0 e 0 0 0
0 K 0 p 1 0 K 1 0 1
0 0 0 1 0 0 G 0 0 1
1 0 K p 0 1 P 1 0 K
E 0 0 0 P 0 0 1 0 p